GGGGGGGGGGGGGGGG
GOOOOOOOOOOOOOOG
GOOOOOOOOOOOOOOG
GOOOBOOOOOOOOOOG
GOOOOOOOOOOOOOOG
GOOOOOOOBOOOOOOG
GOOOOOHOOOOHOOOG
GOOOOOOOOOOOOOOG
GOOOOOOOFOOOOOOG
GOOOOOOOFFFOOOOG
GOOOOOOOOOOOOOOG
GGGGGGGGGGGGGGGG